1000 1000
WTM = ZFB + ZFB
FQJ = ZPE + ZPE
SAE = AER + AER
AZX = KSZ + KSZ
HQN = AJS + AJS
RAX = ZZQ + ZZQ
FX = JJU + JJU
HBQ = CHH + CHH
VZY = AXL + AXL
YHQ = EEJ + EEJ
FAI = QVP + QVP
RQP = HCB + HCB
FQC = GNK + GNK
TLC = JM + JM
CM = GU + GU
LAY = GBZ + GBZ
SAI = CPQ + CPQ
TZX = BDK + BDK
NFS = LV + LV
QGJ = TQV + TQV
TIV = UBY + UBY
NT = MGG + MGG
PFE = IVU + IVU
KJA = UOU + UOU
CZN = CGM + CGM
OIQ = MTG + MTG
QDX = ERV + ERV
FAJ = PUL + PUL
JTO = KSB + KSB
RYU = YIC + YIC
MAF = NUH + NUH
DZA = LSQ + LSQ
GUI = NTO + NTO
K = ANP + ANP
VIQ = GIA + GIA
SJ = KAP + KAP
JOT = YTS + YTS
STI = IRE + IRE
TK = BFC + BFC
IGY = SPC + SPC
MQ = DQ + DQ
JNE = UHD + UHD
LZI = VHC + VHC
AWG = FN + FN
MKN = VEV + VEV
VJI = AVP + AVP
QIL = KXZ + KXZ
KEF = TAZ + TAZ
JFW = KTY + KTY
PBQ = GYX + GYX
UAO = KW + KW
LJ = QOE + QOE
ASW = FRK + FRK
PU = PAA + PAA
DNO = TZI + TZI
GBF = JRN + JRN
FXY = PUD + PUD
YVR = LNQ + LNQ
IUT = HXC + HXC
PY = DAJ + DAJ
AYO = DIB + DIB
NZD = QT + QT
NDD = DK + DK
ZAO = JYQ + JYQ
MTG = CVK + CVK
JRF = OG + OG
VEY = WX + WX
BNC = JUR + JUR
BOG = ELP + ELP
DZT = HP + HP
VNZ = MUA + MUA
TQD = QMZ + QMZ
ZNQ = JPJ + JPJ
UZS = YHS + YHS
WIB = LBA + LBA
KKE = AXN + AXN
RZA = DMO + DMO
TO = NIR + NIR
GDK = MHW + MHW
QDK = ZZ + ZZ
OIR = POL + POL
AUJ = XZE + XZE
BCS = QUI + QUI
SBZ = ZKV + ZKV
NTO = LCB + LCB
JUZ = RAQ + RAQ
MSF = TOO + TOO
GVA = IYH + IYH
UTF = LTH + LTH
SE = QA + QA
IFH = GJ + GJ
PT = DHJ + DHJ
CNF = JR + JR
JFX = XMA + XMA
VG = DO + DO
VIH = ATM + ATM
PPQ = NZ + NZ
HEB = MKB + MKB
NXD = RUE + RUE
GHI = RYB + RYB
ZF = FWP + FWP
BZV = ZTI + ZTI
TVR = GRB + GRB
TKK = PGN + PGN
DVL = SJ + SJ
TIM = KA + KA
TWV = DZY + DZY
XSL = GGA + GGA
CKJ = CGM + CGM
FEW = HOS + HOS
UHD = VEH + VEH
CDF = IRE + IRE
Q = STO + STO
DBQ = BWA + BWA
TZJ = NII + NII
BYE = QIC + QIC
BCB = DRO + DRO
XAX = WZD + WZD
OOU = DDV + DDV
OLV = GKB + GKB
AKI = NOE + NOE
VFK = WJQ + WJQ
MKC = ZAU + ZAU
NSO = BMV + BMV
TYD = JMY + JMY
URZ = MUF + MUF
ELO = TKJ + TKJ
CNY = WSA + WSA
KAE = LR + LR
CDK = QOB + QOB
CPE = IN + IN
BNW = OFO + OFO
XAC = TVO + TVO
PW = KTJ + KTJ
FX = REP + REP
XDP = GOH + GOH
VJV = FCT + FCT
RDH = CFQ + CFQ
TDH = ONA + ONA
KJV = XFB + XFB
WWL = CPB + CPB
FUS = JQX + JQX
GNI = SSI + SSI
SKN = INT + INT
MFP = XMG + XMG
FWZ = MV + MV
FUO = WRT + WRT
EPN = DGZ + DGZ
XIQ = THW + THW
LZI = WLZ + WLZ
PU = YOE + YOE
JMU = QUI + QUI
VV = QBW + QBW
LEX = CEM + CEM
CJO = DTE + DTE
KUH = DAY + DAY
UKY = MCW + MCW
COE = RTF + RTF
OUP = QIC + QIC
PQ = QY + QY
GHI = AQM + AQM
WLP = ZRD + ZRD
UZQ = PAT + PAT
GNB = CGM + CGM
UBZ = ZBA + ZBA
KPU = HGA + HGA
RMQ = YHG + YHG
PAG = DJB + DJB
OAD = GTY + GTY
NAA = ZKQ + ZKQ
UAJ = BNL + BNL
WKO = RWN + RWN
FTH = TJQ + TJQ
CJL = LQP + LQP
JIP = LOL + LOL
ZBA = KF + KF
XJE = FQJ + FQJ
DRZ = EJR + EJR
WZC = URS + URS
JR = BLJ + BLJ
ZKS = BOG + BOG
YDF = OTW + OTW
JJU = ASR + ASR
SCD = JOT + JOT
BTT = WFL + WFL
LL = ILB + ILB
YXH = NJY + NJY
FJD = WW + WW
IBF = PZU + PZU
PGB = YMN + YMN
YFN = KGR + KGR
UKG = MHI + MHI
NCV = CKL + CKL
KZ = EPL + EPL
WNG = BHX + BHX
XKR = PCC + PCC
GTE = VWB + VWB
YQU = CQL + CQL
UDN = YLJ + YLJ
XOL = NEJ + NEJ
SDY = JS + JS
JU = SYI + SYI
GOF = HO + HO
MJZ = TI + TI
UAJ = KPY + KPY
WEF = BO + BO
YW = OJC + OJC
DDS = J + J
RSF = TWC + TWC
PJX = BZC + BZC
RAK = JFA + JFA
TJ = SPP + SPP
SFK = EFM + EFM
QQV = PRY + PRY
HVK = WSR + WSR
YUK = RUH + RUH
ZDY = SED + SED
MJT = EUC + EUC
ESU = ZOA + ZOA
YBA = AXM + AXM
GJN = MK + MK
GGY = MVB + MVB
CXL = XRG + XRG
CRI = HHJ + HHJ
UB = LWP + LWP
IC = XRH + XRH
LOK = GHL + GHL
QRF = UCP + UCP
HSH = FSS + FSS
JRP = NPN + NPN
AJY = YMW + YMW
LPQ = WPU + WPU
CBY = DYM + DYM
BCP = YIJ + YIJ
JQV = LG + LG
YMI = WTM + WTM
KTR = QQB + QQB
FHB = QZD + QZD
CYF = GYV + GYV
FSQ = HVC + HVC
VPO = UEE + UEE
VY = YDP + YDP
AMS = CWI + CWI
RTO = UJQ + UJQ
SCX = XTA + XTA
IUE = XHT + XHT
RIU = EIE + EIE
DXD = XBT + XBT
TOB = TMW + TMW
TD = HQP + HQP
JSR = PJT + PJT
YDK = QPA + QPA
RIY = JWB + JWB
YUG = ELR + ELR
HTP = YYW + YYW
MC = VQE + VQE
FJM = YKR + YKR
XGB = PUL + PUL
NAT = VUV + VUV
WDY = CK + CK
MLS = DAH + DAH
XID = NBZ + NBZ
JHN = LMO + LMO
VLT = GGR + GGR
FVZ = NOJ + NOJ
UPV = KNK + KNK
BPT = FPX + FPX
DUU = OBM + OBM
VIS = FXR + FXR
JAU = DHZ + DHZ
MZO = YYW + YYW
WLA = VAL + VAL
JNZ = DGH + DGH
FFA = RWP + RWP
EPH = IWD + IWD
BV = WG + WG
NTC = OGN + OGN
WCM = JCG + JCG
NZU = QYH + QYH
XSQ = FQS + FQS
FAV = MT + MT
NF = SPX + SPX
ZR = WKK + WKK
EHW = GDM + GDM
HOG = HBM + HBM
EER = KKX + KKX
OQ = DNA + DNA
IQY = VLG + VLG
ILC = GPZ + GPZ
GSF = ALT + ALT
ZH = EPA + EPA
RV = NGT + NGT
DWU = WVF + WVF
MWF = VMQ + VMQ
NZD = RJY + RJY
CTN = FRA + FRA
JFX = VYA + VYA
MVG = SLO + SLO
NFY = IUS + IUS
ZHJ = NDG + NDG
SQL = OUP + OUP
VJY = EAI + EAI
SPF = QMN + QMN
DEQ = ALT + ALT
SCW = FTO + FTO
PDY = QHS + QHS
ZNN = FBW + FBW
BT = GKY + GKY
XJK = ZW + ZW
YCY = OZO + OZO
KIL = MBO + MBO
JH = WMI + WMI
GTI = HLK + HLK
GSM = SOR + SOR
VLO = FMU + FMU
ECD = AHU + AHU
ZEI = HHK + HHK
XPB = NX + NX
NED = RAD + RAD
UMI = XCK + XCK
OJC = SXS + SXS
BPU = TSM + TSM
FBW = RA + RA
RZ = AJK + AJK
OAS = YGJ + YGJ
ZDU = DEE + DEE
JMF = FCI + FCI
AOV = DLT + DLT
GQK = HNY + HNY
RKH = UKW + UKW
LRW = BHI + BHI
RWB = QFU + QFU
LAP = QCH + QCH
MLE = FHV + FHV
HO = CDF + CDF
NNT = SBY + SBY
ROU = TVR + TVR
IGY = TLC + TLC
XOU = VX + VX
WXI = NOE + NOE
SKE = EJI + EJI
BAO = KRR + KRR
CQV = QVT + QVT
FY = HOC + HOC
BLL = AGH + AGH
RJY = PNE + PNE
TSM = LCJ + LCJ
KZW = CP + CP
IEG = QF + QF
KSU = QPA + QPA
XZU = IRP + IRP
OWS = FPQ + FPQ
SIA = ZFG + ZFG
ZWK = AKT + AKT
IQQ = JFZ + JFZ
SO = HLK + HLK
JNX = JSJ + JSJ
CFZ = JFK + JFK
IIZ = GNL + GNL
YIZ = SHL + SHL
YR = KUZ + KUZ
W = IN + IN
CZ = OPW + OPW
VPT = GPE + GPE
WJQ = LLK + LLK
FEI = RTT + RTT
XNP = VOT + VOT
GJA = ZTX + ZTX
ZCL = QMQ + QMQ
FEJ = TNK + TNK
YRS = VOJ + VOJ
WZG = THF + THF
LYT = DIA + DIA
OJX = KUM + KUM
EST = EMO + EMO
JEC = RQQ + RQQ
AHF = QMN + QMN
NCG = UTS + UTS
ZEU = EPY + EPY
MMR = VIH + VIH
WB = PED + PED
FTV = QY + QY
OGE = BTF + BTF
KXD = CDB + CDB
TBO = WBN + WBN
PO = ZMR + ZMR
PMV = BYK + BYK
YDF = NMJ + NMJ
EPH = UTA + UTA
WWE = NUI + NUI
FET = SSJ + SSJ
PC = FPK + FPK
QGK = LH + LH
DNP = EPA + EPA
QBM = YLE + YLE
URH = GKB + GKB
EER = DWF + DWF
JCZ = THW + THW
UDK = ZTY + ZTY
CXH = UYN + UYN
QNG = GYH + GYH
EOS = FJR + FJR
TXX = JQD + JQD
HLX = CB + CB
EGF = GOQ + GOQ
AYO = ZQX + ZQX
LFJ = HSU + HSU
RTY = ZHJ + ZHJ
RNX = MAB + MAB
JEQ = JLQ + JLQ
COH = DOT + DOT
IKZ = XQR + XQR
QZ = HRP + HRP
ZMX = HBG + HBG
LKY = VSS + VSS
EWY = RAP + RAP
WLT = UDM + UDM
CVK = JGB + JGB
VJV = JF + JF
RW = HJU + HJU
AMV = YMW + YMW
EG = AVZ + AVZ
HFL = UTJ + UTJ
IRJ = BPU + BPU
GUW = MTM + MTM
STK = AMC + AMC
HID = OQJ + OQJ
PQI = DI + DI
XIE = WX + WX
WPG = DO + DO
YVA = QJT + QJT
WLM = YZX + YZX
NTM = KDE + KDE
VP = NQF + NQF
JBS = LMB + LMB
VSX = YTE + YTE
HAO = DDV + DDV
JRF = IRJ + IRJ
YE = SZJ + SZJ
TAK = LYL + LYL
LDI = PKK + PKK
ZYM = DG + DG
LWY = DAN + DAN
ZIS = ZBW + ZBW
DAY = JFG + JFG
EJI = UTJ + UTJ
NTK = XQR + XQR
VBG = GSM + GSM
WMP = MUD + MUD
JXW = YQU + YQU
CPY = WLK + WLK
ZJB = NKK + NKK
RFH = MGK + MGK
FFH = LL + LL
HU = NEB + NEB
BDD = EDG + EDG
QTF = VXY + VXY
DDY = YDO + YDO
NMB = QST + QST
NXO = MKW + MKW
IPX = JNZ + JNZ
JIP = UBJ + UBJ
XUE = BPR + BPR
SQ = ILL + ILL
RBE = BXV + BXV
VQL = RTV + RTV
QP = XL + XL
WKX = KNG + KNG
IAQ = HNJ + HNJ
AIF = YFW + YFW
IVJ = BB + BB
SWF = VDW + VDW
SKV = EH + EH
BRR = TXX + TXX
IG = THA + THA
ZW = IXK + IXK
HXP = MX + MX
FAA = EEJ + EEJ
ZYF = ZZN + ZZN
EBB = PAA + PAA
EUM = SYX + SYX
IYI = LYK + LYK
YBE = QBW + QBW
UWF = EQC + EQC
KDZ = MZO + MZO
KRJ = NDP + NDP
IUE = JTL + JTL
YR = NDP + NDP
ZZP = KUG + KUG
ZFU = YXM + YXM
OGP = NMC + NMC
VLG = BEK + BEK
ZBS = YIC + YIC
POM = RY + RY
QI = OQE + OQE
XJJ = FYA + FYA
BPR = RAE + RAE
MLS = JRD + JRD
QHT = MIQ + MIQ
REK = OOY + OOY
MG = WCM + WCM
RJE = IRN + IRN
DLN = GL + GL
QAT = QLB + QLB
JKJ = WNA + WNA
FUY = FKL + FKL
VTI = LMO + LMO
WZG = OZS + OZS
HVE = JRY + JRY
QQV = LLV + LLV
IYO = SLN + SLN
SWN = FSQ + FSQ
ZMX = OWB + OWB
QGE = PLR + PLR
RVY = LLC + LLC
TV = AHU + AHU
QHX = IE + IE
ZOA = MAJ + MAJ
JSJ = MPH + MPH
PLL = EAN + EAN
GMD = YDR + YDR
VTZ = FRD + FRD
AMB = KKV + KKV
LDE = SQI + SQI
BRB = UDQ + UDQ
XSR = EAN + EAN
DUY = DXI + DXI
HRP = FPR + FPR
OGJ = YZF + YZF
MBJ = MPA + MPA
C = SZJ + SZJ
ZMZ = JHZ + JHZ
UAJ = JHB + JHB
UWF = EUP + EUP
UXH = JTO + JTO
UTT = YQB + YQB
OXJ = WDR + WDR
DWF = HCO + HCO
QAC = IEJ + IEJ
MN = FLQ + FLQ
VA = VPU + VPU
YBR = SN + SN
XSR = ZHD + ZHD
RXD = SOA + SOA
BKK = KXD + KXD
WTM = ELO + ELO
EVF = UXC + UXC
AQH = QMZ + QMZ
SBH = QGC + QGC
IWD = QDA + QDA
BEF = BFC + BFC
GVI = SAO + SAO
HDJ = BUL + BUL
YYK = KFD + KFD
HRP = CAB + CAB
WBI = SKN + SKN
TOB = FGB + FGB
TYC = HQQ + HQQ
TCC = SCE + SCE
WSA = NXP + NXP
CKQ = TNM + TNM
JQM = BY + BY
IUE = EKR + EKR
NGT = GNZ + GNZ
PJP = KWE + KWE
RGV = MJT + MJT
AN = III + III
VG = PNR + PNR
HDT = AMI + AMI
OZY = SB + SB
CZA = KKX + KKX
KNX = XLP + XLP
VN = KOG + KOG
QKE = JFK + JFK
GSU = VGT + VGT
ZVR = RBV + RBV
YCU = TVZ + TVZ
MFP = IT + IT
JOF = SOB + SOB
OPT = DIO + DIO
YZM = BQU + BQU
TI = PZL + PZL
NUD = WFC + WFC
SVU = UYK + UYK
ZHC = YL + YL
POI = XTF + XTF
PUH = FKF + FKF
JDY = QHM + QHM
XYK = IQY + IQY
OTX = ZBJ + ZBJ
OQM = TLF + TLF
DLA = IJS + IJS
ZPA = YH + YH
FVV = TDA + TDA
GUI = AB + AB
ZMI = PO + PO
KZL = LSP + LSP
XSV = KFL + KFL
LOW = FZD + FZD
CX = KFM + KFM
RHQ = RUE + RUE
HWV = SET + SET
PBB = XMG + XMG
DBC = BOP + BOP
PQI = XNB + XNB
YUG = YOH + YOH
VSW = ASR + ASR
WNS = CTR + CTR
PBT = UGH + UGH
ONA = XNJ + XNJ
WPF = ZMT + ZMT
HSU = ZEY + ZEY
FGI = VZS + VZS
CJF = JXV + JXV
QYW = HF + HF
DWH = PFR + PFR
IRL = FAK + FAK
GWU = EBD + EBD
BIX = BLP + BLP
GQF = HH + HH
GNI = BN + BN
XSQ = HCB + HCB
IZW = RYU + RYU
USI = VRP + VRP
PYJ = COE + COE
HPJ = FHT + FHT
WJG = WZG + WZG
UTN = STG + STG
YLE = KEO + KEO
MNU = XBT + XBT
MPA = VIQ + VIQ
QZM = SZZ + SZZ
XNJ = VRP + VRP
AQN = UTS + UTS
SML = ZJS + ZJS
GU = ERW + ERW
VKH = ZQC + ZQC
JVP = LG + LG
AXM = VFK + VFK
BUR = IHN + IHN
RCF = NYU + NYU
CBU = FBW + FBW
STD = VVO + VVO
URJ = TYF + TYF
MRU = EYW + EYW
SRW = HJZ + HJZ
VYA = MSF + MSF
OYF = CKC + CKC
KQG = HXE + HXE
QZM = MAR + MAR
SNC = WEB + WEB
PN = YEP + YEP
PFY = OHS + OHS
TIV = AOV + AOV
MXM = YC + YC
KPQ = HAL + HAL
QXH = UTA + UTA
OJP = ORS + ORS
PXR = YBN + YBN
IGX = JJJ + JJJ
EIK = MUF + MUF
GRP = JCZ + JCZ
XKG = CQS + CQS
MTI = MRF + MRF
SNE = DGI + DGI
EWY = QPA + QPA
QLJ = RG + RG
FGH = OCA + OCA
HPI = MGY + MGY
CMA = ECU + ECU
GZC = ASD + ASD
JEC = SFL + SFL
CTZ = DMZ + DMZ
IIG = GMD + GMD
FSQ = FXR + FXR
ZKB = TGG + TGG
XLC = FVL + FVL
HK = BPV + BPV
YU = INL + INL
QTW = CHF + CHF
RSA = PTL + PTL
RAP = UD + UD
DFM = RIS + RIS
RDH = PXR + PXR
VXQ = TYW + TYW
YUS = JWO + JWO
QB = FZW + FZW
NJB = FA + FA
RRH = ABC + ABC
QH = VYA + VYA
ZOR = BFS + BFS
FNM = XHX + XHX
HGI = PBQ + PBQ
XHZ = IVF + IVF
PI = UZY + UZY
CKD = FYV + FYV
YDO = QSR + QSR
BL = ZAQ + ZAQ
JHD = MXI + MXI
LPE = GZE + GZE
HLX = NYZ + NYZ
SOB = RRM + RRM
UWO = GRJ + GRJ
SOQ = OQF + OQF
SOM = BEB + BEB
KT = SLO + SLO
DXN = FAK + FAK
ARP = TIV + TIV
DBO = ZMO + ZMO
JO = ACD + ACD
MLH = XCT + XCT
UUL = TIA + TIA
PRA = PYK + PYK
VP = QFY + QFY
QDG = MK + MK
MWF = MBC + MBC
KIG = HQG + HQG
LTJ = UCP + UCP
SFU = DPU + DPU
HFN = JCU + JCU
WVG = JWM + JWM
OKM = AIK + AIK
PUO = SYV + SYV
APL = NZ + NZ
MTM = MXR + MXR
HWT = IBN + IBN
BWE = OBY + OBY
LDF = WRH + WRH
PCR = EYC + EYC
NFS = YLZ + YLZ
XFM = YO + YO
JSV = DAY + DAY
TD = KB + KB
YDP = VVK + VVK
VPB = WXF + WXF
XZL = LPU + LPU
FRQ = KSY + KSY
MKB = VTD + VTD
BAQ = OA + OA
YUY = UMK + UMK
FX = QYG + QYG
EAV = RB + RB
EVP = NOM + NOM
GVX = RCK + RCK
NRM = TLA + TLA
FGM = TFA + TFA
IAJ = CWZ + CWZ
MHW = VXG + VXG
HCC = ZJU + ZJU
CFY = JSD + JSD
EM = ZS + ZS
XCD = WZG + WZG
TEK = OM + OM
BST = WKK + WKK
THW = RI + RI
HBX = OQT + OQT
XCC = MTW + MTW
URZ = TVB + TVB
LBJ = ZDK + ZDK
BYX = NDD + NDD
CPH = JDE + JDE
XAK = TJE + TJE
YCT = FVP + FVP
SJS = KUQ + KUQ
CZN = GOU + GOU
QD = NDP + NDP
LOW = AHF + AHF
VUC = HZA + HZA
LBN = WCN + WCN
AAH = ROP + ROP
MVC = QNG + QNG
UTJ = RIY + RIY
GKR = LIF + LIF
URV = TKM + TKM
OQT = ARP + ARP
JJK = TM + TM
ZOM = JWL + JWL
TJU = OGJ + OGJ
NWB = RDR + RDR
DCQ = AMI + AMI
VJX = DUU + DUU
WME = WB + WB
RBY = EUQ + EUQ
BCD = LZM + LZM
WXR = PDV + PDV
UTN = CDR + CDR
IS = PCJ + PCJ
AFG = GZ + GZ
SDL = HWM + HWM
JJQ = AN + AN
DWF = ALC + ALC
IWT = MP + MP
NHC = FGM + FGM
FWP = EHN + EHN
CQS = HQE + HQE
ZJU = CGR + CGR
MLP = BOM + BOM
DZT = NZY + NZY
ZKB = VJQ + VJQ
EHM = DXX + DXX
SSK = OSY + OSY
SGY = LYF + LYF
QYJ = VAU + VAU
GQK = CI + CI
CJY = PRO + PRO
AFD = ZZR + ZZR
SK = OIR + OIR
VCC = JCV + JCV
HAL = RPH + RPH
SNC = HUH + HUH
TMT = PXV + PXV
NXJ = CQV + CQV
OEA = WOU + WOU
XQN = DF + DF
BCR = ZPK + ZPK
RL = EAH + EAH
BUO = DJM + DJM
OY = OVH + OVH
WVX = HJM + HJM
AGZ = FEI + FEI
VBU = BEJ + BEJ
JCB = JL + JL
NFH = YDF + YDF
WBA = LIC + LIC
OJ = VKA + VKA
QYJ = FIO + FIO
SFL = GFX + GFX
VNC = OGH + OGH
JHW = TVR + TVR
BTT = ZFU + ZFU
TQD = BWS + BWS
ZLV = SUM + SUM
MJO = HHY + HHY
IBZ = WP + WP
VQM = FX + FX
QNJ = YEI + YEI
ZGK = FRQ + FRQ
Q = AZP + AZP
IEY = ZTX + ZTX
HOA = UYX + UYX
HZW = YWP + YWP
WOU = MF + MF
ZPE = PDX + PDX
MXR = HXJ + HXJ
EOS = YYB + YYB
JPL = RTT + RTT
XLE = YII + YII
UOO = JQH + JQH
YMM = WXM + WXM
ETA = GQR + GQR
VHM = BT + BT
GK = PNK + PNK
CJA = MKW + MKW
ZGR = JPI + JPI
YKR = OI + OI
Y = GSM + GSM
IVY = TJX + TJX
NJS = CBY + CBY
SQK = LUW + LUW
YWX = LTL + LTL
MXO = MNH + MNH
DGQ = ZRD + ZRD
UM = ATL + ATL
HWB = OVV + OVV
HWM = HXX + HXX
OYP = TWL + TWL
EHM = UGL + UGL
ESN = VXY + VXY
EGV = ASW + ASW
YYK = KLI + KLI
ARA = JHB + JHB
WPF = JYC + JYC
IJS = MFO + MFO
XQH = QVX + QVX
IDE = TJ + TJ
BXK = WKX + WKX
DPI = NAA + NAA
CSH = KIG + KIG
SV = WWE + WWE
WAF = HUW + HUW
WJH = SEQ + SEQ
FF = CNN + CNN
FRG = TLA + TLA
XJE = GFE + GFE
BLN = JXI + JXI
DIJ = HPV + HPV
GPT = QZQ + QZQ
YC = IJJ + IJJ
BYU = PVW + PVW
TSX = YZX + YZX
HKP = DAN + DAN
JDQ = NKL + NKL
UK = BGU + BGU
HEX = ABI + ABI
ZHD = XTZ + XTZ
KZC = AJR + AJR
POL = CP + CP
WCX = DTR + DTR
BAS = CZZ + CZZ
EMJ = EFY + EFY
BQI = AGP + AGP
IGZ = QAZ + QAZ
RT = MAB + MAB
FW = OBM + OBM
XCS = RDS + RDS
MNU = RVU + RVU
FVI = XSO + XSO
BEI = ISR + ISR
HHY = IRP + IRP
LNQ = XSY + XSY
YKZ = ILI + ILI
KR = WQQ + WQQ
RXT = NOA + NOA
FKP = GBN + GBN
NJB = DXW + DXW
BNK = RWS + RWS
ZXU = VFO + VFO
KNO = TQD + TQD
WP = KKS + KKS
PBG = XWR + XWR
QIW = HGZ + HGZ
RCM = ABM + ABM
FWD = FJQ + FJQ
YIZ = AZC + AZC
SDF = YCL + YCL
FSU = JRM + JRM
ZMK = MTB + MTB
TGG = YUS + YUS
JOZ = DAV + DAV
JQC = FGB + FGB
LPN = UGH + UGH
GRN = MW + MW
SKK = HTB + HTB
KOZ = MKW + MKW
JDI = CYP + CYP
NOJ = JQS + JQS
YHY = XHL + XHL
JDF = HVA + HVA
RAW = BIC + BIC
JHN = HT + HT
LTC = UIC + UIC
ZXH = XFL + XFL
GD = PJX + PJX
LGA = FCY + FCY
LDO = CEU + CEU
VEN = UKC + UKC
CPQ = RWF + RWF
HHL = TVC + TVC
UOW = VQL + VQL
AU = EAA + EAA
JTT = VSV + VSV
QYL = NGQ + NGQ
TDA = FC + FC
QDK = XUE + XUE
RKJ = ONN + ONN
JZZ = MTQ + MTQ
ANJ = UJ + UJ
SLX = KK + KK
ZUU = HVN + HVN
DHH = MAP + MAP
OOA = UPR + UPR
ZYN = XMG + XMG
ZQM = JFG + JFG
ZAU = TZJ + TZJ
BL = SPC + SPC
KFW = XMO + XMO
USZ = SPP + SPP
NMO = PHF + PHF
XSR = ANA + ANA
UFM = YS + YS
TQZ = QON + QON
RR = LMB + LMB
HA = JQC + JQC
XCQ = ZAK + ZAK
CLB = OVS + OVS
FSF = JCM + JCM
JZU = HC + HC
QDA = EA + EA
JFK = ZFS + ZFS
FGC = RW + RW
CPQ = DWA + DWA
DDK = NYD + NYD
DPI = RYC + RYC
ZMK = YLV + YLV
QXU = XTP + XTP
NLS = CPB + CPB
NWA = YOL + YOL
VXY = ZXH + ZXH
CLB = ENK + ENK
YOA = JVN + JVN
PCN = ARN + ARN
BYK = JJJ + JJJ
VGS = TGL + TGL
VZY = VXJ + VXJ
TIO = JWO + JWO
JNE = BLL + BLL
CGM = XFB + XFB
VSR = XJK + XJK
SXV = HQP + HQP
MRS = CKD + CKD
THP = OMQ + OMQ
ARQ = LWS + LWS
ESI = YMR + YMR
CMS = QOF + QOF
LLY = SV + SV
OUK = ZX + ZX
ARR = SGD + SGD
QAW = NID + NID
ZVU = HXA + HXA
YZN = IZB + IZB
FDI = ITD + ITD
UIK = PLI + PLI
NFN = XBA + XBA
VMF = RAQ + RAQ
NWO = PRI + PRI
ECZ = OYB + OYB
ZHW = VJS + VJS
NOK = JYA + JYA
MBW = GAQ + GAQ
SE = AZT + AZT
ITX = UOG + UOG
QMA = UPY + UPY
XDZ = WLX + WLX
JUB = BPB + BPB
EH = QYC + QYC
KBK = ICT + ICT
SKL = PS + PS
NSD = LBO + LBO
ZZK = UL + UL
QIW = EHY + EHY
UAH = PWI + PWI
SEP = YNZ + YNZ
GN = IWG + IWG
HC = QRG + QRG
QUF = VSK + VSK
QKG = CYR + CYR
COB = ZUG + ZUG
UQU = TLL + TLL
VQJ = IQB + IQB
ZY = BDY + BDY
DEN = LNR + LNR
LKP = GJI + GJI
NBG = JKY + JKY
REB = XRS + XRS
TTZ = FLX + FLX
KKZ = XDJ + XDJ
WKP = YPG + YPG
GWL = DNM + DNM
MED = NFE + NFE
NZM = HOL + HOL
BQI = CKD + CKD
KLY = TVF + TVF
HER = TI + TI
WTA = XCG + XCG
HP = FM + FM
ETT = VIM + VIM
ZNF = BJH + BJH
VGP = XRC + XRC
SM = JBP + JBP
UDC = EFA + EFA
QK = ZQO + ZQO
GEF = KCG + KCG
JDW = VQP + VQP
IUK = VAR + VAR
JFC = QGE + QGE
MEQ = ULI + ULI
ESC = GBA + GBA
YNO = IGP + IGP
YMW = BCD + BCD
VVR = IJ + IJ
VXP = VWS + VWS
SDW = YHA + YHA
XVN = GFF + GFF
EKD = BFO + BFO
HSK = XEY + XEY
WVU = MO + MO
EZY = JGR + JGR
IYG = BTZ + BTZ
KWP = WUH + WUH
QFG = HV + HV
ZPE = REB + REB
QST = CBS + CBS
NSY = YZO + YZO
XDI = NUV + NUV
KFJ = MMN + MMN
APC = CF + CF
VU = PCU + PCU
QFF = ND + ND
ZHS = HQQ + HQQ
GMW = YDA + YDA
RDB = RIB + RIB
TI = BXO + BXO
YOG = OAQ + OAQ
IJC = WLC + WLC
UKB = YMC + YMC
ENX = LAS + LAS
MJV = MNQ + MNQ
IP = CAM + CAM
QVQ = KMA + KMA
SDT = BXJ + BXJ
WDD = NJF + NJF
SSB = UWW + UWW
UYA = LLW + LLW
DIX = KNW + KNW
ZZY = NAU + NAU
LST = BOZ + BOZ
PMY = QRA + QRA
IHA = CQA + CQA
NCU = MRB + MRB
UM = LEZ + LEZ
KLC = JWA + JWA
EFW = DPN + DPN
QIY = FWA + FWA
ESC = PZ + PZ
ZLC = QMW + QMW
NBG = WWK + WWK
CNI = WPA + WPA
WSZ = CU + CU
YLK = ETE + ETE
NNI = OQT + OQT
OOJ = SCM + SCM
JAX = IMB + IMB
OQL = TCV + TCV
EUZ = MQD + MQD
FAF = IAL + IAL
RUJ = QEL + QEL
VOK = OTO + OTO
EGX = DEC + DEC
ISW = XXB + XXB
PBN = FRB + FRB
ZS = MDM + MDM
PFF = ZGW + ZGW
YH = TYM + TYM
SUI = JUG + JUG
OQO = FAX + FAX
JF = UEE + UEE
FBG = TEQ + TEQ
PEN = DUD + DUD
CXV = HDR + HDR
GBA = SJX + SJX
NHY = WX + WX
UCW = TWK + TWK
WCN = JVV + JVV
QYP = RSH + RSH
PG = PTT + PTT
KVC = BO + BO
JBQ = MF + MF
EWA = FFO + FFO
OQY = XKN + XKN
WID = TR + TR
ZMC = LWI + LWI
GLM = ZPM + ZPM
NDK = PZF + PZF
SZ = KRW + KRW
PV = IIJ + IIJ
QCH = HOJ + HOJ
ZBK = HVM + HVM
UFL = XGN + XGN
TPU = CZD + CZD
SZQ = PHR + PHR
MVB = ZXK + ZXK
PCH = EWI + EWI
SH = RGP + RGP
KRN = EAC + EAC
MTZ = YPU + YPU
FJI = MJV + MJV
O = ZRI + ZRI
GV = HAK + HAK
PZE = HXU + HXU
EHO = SCA + SCA
MMJ = SJP + SJP
CEO = WOC + WOC
CRH = HJX + HJX
GFU = DTD + DTD
LD = RDX + RDX
YFN = LAT + LAT
XRE = FHM + FHM
BID = LW + LW
IZK = QKQ + QKQ
QWC = BEF + BEF
BRO = QKB + QKB
SRX = CF + CF
WNE = VHO + VHO
SAS = KWA + KWA
XUJ = EEM + EEM
QRS = EXG + EXG
WQB = ESQ + ESQ
BXG = MSV + MSV
WQB = JQE + JQE
JGG = XPE + XPE
KTP = YPU + YPU
UFQ = KEC + KEC
NQL = CLS + CLS
LKI = DES + DES
VWJ = RYA + RYA
IZ = KTL + KTL
DRO = FSN + FSN
JEM = LGO + LGO
DTO = KWC + KWC
KIH = OFQ + OFQ
VRE = JRV + JRV
FYC = GPK + GPK
CSL = OWA + OWA
ILH = DLF + DLF
RGC = SID + SID
KAE = TH + TH
WV = BDF + BDF
XN = XID + XID
JP = WYN + WYN
HFD = WJ + WJ
BZC = OW + OW
HE = VNX + VNX
HTV = PIH + PIH
HDH = YGQ + YGQ
YF = GOM + GOM
WMF = LMK + LMK
LVP = UUC + UUC
JDD = GTH + GTH
MRR = DVX + DVX
AHH = FW + FW
ULQ = URN + URN
NQL = XRE + XRE
VBV = PVS + PVS
XWI = ALN + ALN
ZGO = PVZ + PVZ
DAB = QWN + QWN
HPX = KZ + KZ
HCK = HWT + HWT
BX = XNB + XNB
PQW = EDQ + EDQ
GIB = NP + NP
OQZ = CQ + CQ
JRJ = TEX + TEX
KO = ZNV + ZNV
EKD = CDD + CDD
OUD = KQL + KQL
FZ = TSZ + TSZ
MWL = FSD + FSD
TLY = VUH + VUH
UBG = YAD + YAD
EWR = VUX + VUX
KXQ = WGO + WGO
WJH = EBZ + EBZ
SPN = UXO + UXO
NID = EDS + EDS
OCJ = VGV + VGV
DCD = UHP + UHP
VZX = VOG + VOG
WDQ = KXV + KXV
CXZ = LHV + LHV
DZA = QW + QW
QAJ = SBK + SBK
AYE = YNW + YNW
WTG = SG + SG
OSG = FOA + FOA
WCO = PAH + PAH
NUE = KFN + KFN
UXI = VQG + VQG
PFV = KIM + KIM
ORW = EA + EA
FU = HMW + HMW
LXM = KJU + KJU
KWM = TU + TU
YMR = DN + DN
GZW = SWA + SWA
ZUQ = RDN + RDN
HWN = AED + AED
SEU = HJH + HJH
EZB = ORV + ORV
ULQ = EID + EID
HWT = QFE + QFE
QMW = HQX + HQX
WNE = YZX + YZX
PVR = XGG + XGG
NYT = WPO + WPO
OZP = SRL + SRL
SBZ = HKM + HKM
LAL = OMZ + OMZ
FSB = XBP + XBP
FKJ = LNS + LNS
CH = FCA + FCA
JYF = WKK + WKK
SQH = DSH + DSH
MGH = ERX + ERX
NED = QM + QM
EGX = PPO + PPO
ED = ZVU + ZVU
NUU = AED + AED
SSO = BI + BI
JWL = EMQ + EMQ
NTE = FAX + FAX
CXP = SXV + SXV
DOJ = KVM + KVM
GT = KH + KH
NKP = IBG + IBG
CZ = EOM + EOM
SW = ENN + ENN
NDQ = CPW + CPW
ZDR = AC + AC
KHE = CXP + CXP
QEF = UFL + UFL
PQF = JKP + JKP
CLI = PXJ + PXJ
DAG = KVK + KVK
SJB = DHC + DHC
KXM = BHF + BHF
RVL = ZDR + ZDR
EVT = HID + HID
KPP = HLA + HLA
AIC = OJC + OJC
NL = HCJ + HCJ
IQG = CJX + CJX
VBX = OPL + OPL
NXR = MEQ + MEQ
D = JDP + JDP
ING = RMV + RMV
CLY = KJK + KJK
UGC = LGB + LGB
DH = YDJ + YDJ
JFC = ZXF + ZXF
HDC = RZI + RZI
UTY = RK + RK
TEJ = DUH + DUH
AQA = OGG + OGG
SLW = PIQ + PIQ
RIE = UYF + UYF
YRU = PLL + PLL
XD = HMO + HMO
SFJ = TAB + TAB
HXH = DPD + DPD
NNU = AKA + AKA
YF = XWS + XWS
BQV = DNP + DNP
PB = PRD + PRD
RHW = ACX + ACX
HVJ = JYP + JYP
WPO = GOP + GOP
BCW = SYO + SYO
BZC = OZU + OZU
ELX = PCM + PCM
DPN = NNL + NNL
EVN = GJC + GJC
EOD = VPA + VPA
GTH = TAB + TAB
PCA = LMH + LMH
IYK = DMK + DMK
INL = UQW + UQW
HGL = BSU + BSU
VR = IER + IER
JDD = WLX + WLX
NER = LBN + LBN
HXD = ES + ES
R = XOQ + XOQ
VAC = GJ + GJ
UPY = BQM + BQM
JJN = OMD + OMD
VBY = TRA + TRA
NMG = CE + CE
TRL = XPO + XPO
ZGO = SZQ + SZQ
LIY = OM + OM
LP = QFE + QFE
XJL = LLY + LLY
OKV = DE + DE
KWH = XWO + XWO
VEF = BGO + BGO
LNL = BEG + BEG
SFW = TCF + TCF
WPO = PFF + PFF
XZD = ZWX + ZWX
QPN = YQV + YQV
HOY = CPI + CPI
ZKF = XNR + XNR
FBV = GQX + GQX
BYU = HJN + HJN
MAD = LKF + LKF
IER = OT + OT
GZK = PNC + PNC
EAC = GQ + GQ
SDW = JAR + JAR
DYP = NVX + NVX
FE = OXN + OXN
CFS = WIT + WIT
NAY = CHT + CHT
HU = ALI + ALI
FEH = ZKH + ZKH
UMU = WSZ + WSZ
CLK = BSY + BSY
HW = DHH + DHH
UM = RND + RND
PAR = EPT + EPT
DRG = YZW + YZW
YLV = AGA + AGA
NIZ = NPW + NPW
SE = IHQ + IHQ
XQR = CQQ + CQQ
EQU = NHO + NHO
RAN = QXC + QXC
AVU = BMF + BMF
JW = NVO + NVO
BQD = GUZ + GUZ
IF = DKK + DKK
KNX = ORF + ORF
BCH = SCD + SCD
XFQ = VOC + VOC
HJI = WDY + WDY
UUB = IRH + IRH
PZL = ODQ + ODQ
FLW = KUL + KUL
DRG = STA + STA
TFG = MRB + MRB
AF = AHW + AHW
NQP = EJD + EJD
JVF = WAZ + WAZ
FAV = ASS + ASS
CNW = AQA + AQA
LKI = FAM + FAM
TLO = KTG + KTG
UJX = GOO + GOO
TZB = TIA + TIA
XZ = HFA + HFA
XBT = WBG + WBG
ZGK = SGR + SGR
SGH = IJT + IJT
LVG = OCH + OCH
NOS = SPC + SPC
PQ = TUN + TUN
QRG = LJJ + LJJ
KHX = YSQ + YSQ
YNL = NYV + NYV
EDW = NUU + NUU
PCA = TKN + TKN
SPI = TAO + TAO
RLN = OKV + OKV
CYA = HSY + HSY
XFQ = LCX + LCX
JEU = BMO + BMO
UNF = BGO + BGO
BC = IZE + IZE
GIK = VZX + VZX
PUB = HRW + HRW
SHO = UOK + UOK
BFU = NRC + NRC
HJ = USI + USI
JD = LPS + LPS
NSE = EAZ + EAZ
LJB = VTQ + VTQ
UHB = MDF + MDF
UEW = JWX + JWX
MBC = KHS + KHS
TOW = VPK + VPK
ZCF = UAX + UAX
VIT = BGK + BGK
WJA = TLZ + TLZ
OSH = KCG + KCG
ERH = HNX + HNX
RRR = BI + BI
UJ = TTR + TTR
QLH = WJO + WJO
XQP = GQE + GQE
LNE = IYM + IYM
EVE = UHS + UHS
JRS = LFW + LFW
DLV = MWL + MWL
JWI = FFU + FFU
SIG = WUU + WUU
DZ = MFL + MFL
SQJ = IDT + IDT
TR = DLD + DLD
NLB = HYH + HYH
MBB = SGK + SGK
CUE = RHG + RHG
PZP = EFE + EFE
UZD = HOP + HOP
MSO = RHK + RHK
XKN = SQJ + SQJ
KZA = WMF + WMF
CFS = HFD + HFD
PYI = JIK + JIK
YKT = CPE + CPE
SNE = EDS + EDS
FHB = QS + QS
LXY = VZB + VZB
MC = CLU + CLU
WJF = ZEI + ZEI
QKR = RWM + RWM
HTG = WMH + WMH
PF = DCO + DCO
DMR = FTM + FTM
NVF = CIV + CIV
BNC = WOX + WOX
ZQV = XQJ + XQJ
XCI = RIP + RIP
SB = EUE + EUE
WCP = KGX + KGX
AZE = VTB + VTB
FJS = FVL + FVL
TCG = DRG + DRG
VJS = BHM + BHM
WOX = OXV + OXV
BUU = CV + CV
SPI = ZCL + ZCL
IDC = VWW + VWW
OEJ = BK + BK
JBQ = MDL + MDL
HLV = EEM + EEM
YKO = CSG + CSG
ORO = XML + XML
ZXK = SUW + SUW
TQZ = SIZ + SIZ
NUE = NDT + NDT
IKY = SQX + SQX
TAO = AYA + AYA
XZD = IWG + IWG
XWP = CBD + CBD
YJP = VQY + VQY
OED = GGH + GGH
SS = SAS + SAS
ORG = HKX + HKX
DYP = ZQ + ZQ
DWM = UNK + UNK
DEZ = YLY + YLY
XXY = CAS + CAS
OKU = FYY + FYY
FWH = RGM + RGM
VDA = IJN + IJN
HVM = US + US
JJU = ZSN + ZSN
YSI = AP + AP
FNL = UAO + UAO
BRS = TMQ + TMQ
LQO = FPS + FPS
BID = UJO + UJO
SQE = HZE + HZE
KNX = IZQ + IZQ
JDF = FK + FK
TNF = XAY + XAY
ERG = UDP + UDP
HGI = ZNJ + ZNJ
XBP = MDV + MDV
GJI = EQV + EQV
NJT = FIP + FIP
ZHK = WGZ + WGZ
F = MKA + MKA
NIL = YEQ + YEQ
EIJ = HVJ + HVJ
FOO = PMF + PMF
XIG = ARI + ARI
LYL = EOD + EOD
TWC = AWW + AWW
VIU = CIY + CIY
SMI = BF + BF
SZT = HIK + HIK
ILI = UAX + UAX
TZB = CIY + CIY
NUC = JEX + JEX
HED = SEF + SEF
ZEQ = SZM + SZM
YCO = LRO + LRO
CCQ = UJ + UJ
XVP = ZIV + ZIV
YBM = UKB + UKB
FWM = MTD + MTD
OLG = AUX + AUX
RSD = FFR + FFR
WYZ = OUJ + OUJ
XNV = AKP + AKP
JZL = MLN + MLN
ODO = PKJ + PKJ
LDL = HJN + HJN
XPE = HXH + HXH
CYY = JDB + JDB
MIC = KAK + KAK
YFG = TSI + TSI
WQJ = FD + FD
CZM = JZJ + JZJ
VST = GQ + GQ
XMO = XZD + XZD
ACO = OMN + OMN
XGH = VQ + VQ
EUQ = TVM + TVM
QWN = HR + HR
OMA = ORA + ORA
QWN = WBH + WBH
JC = LDD + LDD
VLE = DRG + DRG
GHY = DCI + DCI
EV = KZQ + KZQ
MOL = XUD + XUD
HKX = IGU + IGU
RVH = AIC + AIC
KXQ = VAS + VAS
ET = LMJ + LMJ
XLE = YUA + YUA
QPG = JSA + JSA
TYQ = MB + MB
EDQ = ERD + ERD
NZW = SAM + SAM
MNN = NPJ + NPJ
LIQ = TO + TO
GFK = EFV + EFV
JBD = HAM + HAM
AH = FNC + FNC
MM = AGY + AGY
WIA = XEI + XEI
RHU = YLG + YLG
YEQ = DPZ + DPZ
QE = LIO + LIO
FJL = XVP + XVP
SLM = XAG + XAG
UNO = DJA + DJA
KGN = BJZ + BJZ
FXI = YJC + YJC
QIU = DLU + DLU
XVQ = IOZ + IOZ
FYB = LBS + LBS
HOS = FBK + FBK
UQP = WWJ + WWJ
WQJ = XNM + XNM
QHA = UZY + UZY
YS = YGB + YGB
ISW = XKP + XKP
PA = NRC + NRC
PZG = VF + VF
YFR = VRN + VRN
BDF = NQP + NQP
DQJ = QBI + QBI
NTL = NXN + NXN
YKT = ZKR + ZKR
XYO = AIR + AIR
OOO = GDX + GDX
ICH = UJT + UJT
SEF = HSB + HSB
SM = HKM + HKM
AFB = CRF + CRF
VLE = YZX + YZX
IFO = LBF + LBF
UKP = DCG + DCG
ZF = UMU + UMU
VKF = OFF + OFF
VK = ISG + ISG
YVY = PIT + PIT
EWL = WAD + WAD
PKP = ARB + ARB
FKW = AIY + AIY
IVZ = UOA + UOA
HHK = PKC + PKC
IPZ = EBV + EBV
KXW = SZH + SZH
XG = IH + IH
XVN = KT + KT
XZG = VEQ + VEQ
WVO = BJZ + BJZ
VLO = GSN + GSN
PNL = IQZ + IQZ
FFU = PZL + PZL
ZGD = TMM + TMM
EHM = MFL + MFL
SJ = HH + HH
VWS = JUD + JUD
DUO = XWQ + XWQ
FX = SQH + SQH
KAY = ONT + ONT
ROI = SQL + SQL
HSV = GPK + GPK
RL = RUR + RUR
NKQ = AC + AC
HGL = PPU + PPU
TBE = UZW + UZW
MGH = REE + REE
JTJ = CIK + CIK
MQ = LFT + LFT
LKI = ODZ + ODZ
XUL = HOK + HOK
EUD = QKE + QKE
JU = ZW + ZW
GBW = JBE + JBE
AIR = JCF + JCF
FJW = QKG + QKG
LVS = HFA + HFA
SPA = NNU + NNU
ZMC = EQU + EQU
XML = LRJ + LRJ
BNG = VTD + VTD
DUD = BMC + BMC
ILI = VNF + VNF
NIU = HKQ + HKQ
CL = WDQ + WDQ
EYL = JSJ + JSJ
KNU = GHS + GHS
AG = HVJ + HVJ
QNC = FFR + FFR
XRO = XXB + XXB
SLH = ANZ + ANZ
MPW = YKZ + YKZ
FMS = OYG + OYG
IUN = YYG + YYG
DPJ = RIV + RIV
AE = UU + UU
LJD = VZV + VZV
OQX = EWB + EWB
NJD = NUP + NUP
DXX = ZKH + ZKH
PR = TMQ + TMQ
AC = VHE + VHE
RSD = GT + GT
FUN = XOR + XOR
JSQ = QPU + QPU
SMD = OQZ + OQZ
OXQ = XJS + XJS
EUZ = XGA + XGA
CFT = HMY + HMY
UDC = HPY + HPY
DLU = KPK + KPK
SNL = DVR + DVR
VIU = KAZ + KAZ
CUG = ZQ + ZQ
UNK = RC + RC
HPO = WKF + WKF
LLW = SNL + SNL
YFX = KGJ + KGJ
FUH = MWI + MWI
KKX = NHW + NHW
SAI = ICQ + ICQ
HDN = MBQ + MBQ
KM = RQT + RQT
LBF = KWR + KWR
DPQ = PU + PU
NHO = LE + LE
XGG = DMO + DMO
EMJ = BJQ + BJQ
IFO = KWO + KWO
WBT = IGZ + IGZ
MGQ = XVQ + XVQ
TEM = CS + CS
ZBX = YS + YS
TD = FLW + FLW
PIQ = INL + INL
NXX = FGC + FGC
UFL = WCK + WCK
FAT = CIY + CIY
ZET = LMJ + LMJ
ZM = VGZ + VGZ
ZXT = DC + DC
XQ = ZFG + ZFG
KXU = DZQ + DZQ
GNB = YZE + YZE
JAW = BIH + BIH
QYS = JVL + JVL
WGK = MYO + MYO
LTK = HBW + HBW
QV = GE + GE
CEM = AFR + AFR
XND = IYD + IYD
LHE = PUP + PUP
UME = KA + KA
KJB = QPG + QPG
THR = SLA + SLA
EKD = OCA + OCA
CZB = SM + SM
LBR = SIZ + SIZ
IER = ESO + ESO
NPJ = YVY + YVY
ZZI = MWT + MWT
IK = UVE + UVE
SYT = KFO + KFO
SSO = MK + MK
XPE = WDS + WDS
IZE = NUX + NUX
WIE = NR + NR
ZQQ = KML + KML
QIQ = ULQ + ULQ
PKN = CK + CK
HDY = LA + LA
QPO = NTE + NTE
PWH = FM + FM
LCM = ZH + ZH
HXH = KW + KW
NUA = WDH + WDH
CGV = QRG + QRG
WSN = IA + IA
NH = JU + JU
DZD = FTT + FTT
JJZ = DVQ + DVQ
SAF = PXB + PXB
EI = HWC + HWC
SYR = VVM + VVM
KXV = VWF + VWF
PR = QAF + QAF
UZ = JRZ + JRZ
WQB = PZF + PZF
OQ = FHM + FHM
VWG = AYK + AYK
TAB = CD + CD
RIN = NED + NED
KMA = TKG + TKG
CNI = FYW + FYW
EEY = HHI + HHI
LAF = JDO + JDO
KXA = VWF + VWF
QJ = MQD + MQD
SFK = JNK + JNK
MJ = VSV + VSV
BV = NCS + NCS
UMJ = YH + YH
GD = VKR + VKR
YO = RA + RA
KEW = KIB + KIB
VQE = OVJ + OVJ
PVH = JV + JV
KUN = IPZ + IPZ
XJN = NSY + NSY
GCF = DCP + DCP
XID = FVD + FVD
XJK = NZ + NZ
KDN = SGR + SGR
AIE = NMC + NMC
LCL = DUD + DUD
BNT = RZL + RZL
PJN = HJI + HJI
NYU = TE + TE
PRE = YNC + YNC
WJ = BOP + BOP
NEE = CEO + CEO
RPC = VV + VV
SCK = NWZ + NWZ
VTQ = CUC + CUC
NWE = DIX + DIX
SY = TZA + TZA
NQP = AQB + AQB
VPE = IUE + IUE
WYX = ZKR + ZKR
ACW = VXP + VXP
UWT = QHJ + QHJ
ASB = PPD + PPD
RKN = NVR + NVR
SES = DOY + DOY
PHH = OEK + OEK
SGQ = PAH + PAH
JNJ = UKC + UKC
BMU = USG + USG
SZY = WNR + WNR
EAC = YOV + YOV
HKQ = QGH + QGH
BQV = BXU + BXU
DXZ = QMV + QMV
BXU = BPG + BPG
IKS = SLA + SLA
XMD = WWU + WWU
ZWU = JYI + JYI
HLM = OCY + OCY
FJ = QHS + QHS
WMW = LOX + LOX
ETV = IJX + IJX
KKZ = FIM + FIM
NKD = TPX + TPX
YDO = YDR + YDR
YQY = FBG + FBG
QOI = GCU + GCU
HGO = EQV + EQV
HUW = HYM + HYM
UXP = EBZ + EBZ
HGG = WB + WB
FSE = LMK + LMK
JA = OWV + OWV
OSM = QZE + QZE
KCR = QVQ + QVQ
YLL = KOC + KOC
RN = DEI + DEI
OWG = NTC + NTC
GXX = ONP + ONP
LEO = FNC + FNC
TCI = JK + JK
FJY = MCW + MCW
OFV = HGS + HGS
KXV = ESO + ESO
QVX = WRW + WRW
CAS = TCF + TCF
JAI = RSL + RSL
WMO = XPE + XPE
HKX = MVK + MVK
MNH = WOA + WOA
AG = MBW + MBW
HXL = HJH + HJH
XLO = TTU + TTU
IFV = NDO + NDO
KM = LGI + LGI
KXV = HDY + HDY
JFN = HQZ + HQZ
NVR = WXY + WXY
WUU = SM + SM
DUO = SKG + SKG
YD = FG + FG
JOD = BPU + BPU
KFW = AKF + AKF
NEW = WIM + WIM
EEY = SFW + SFW
YH = UB + UB
QUF = LM + LM
MZU = SJP + SJP
OIB = MRY + MRY
DOG = BWA + BWA
ST = LVS + LVS
FAC = SGI + SGI
DCF = UAD + UAD
GOF = QZO + QZO
TAN = KML + KML
NKO = FZH + FZH
SMD = WVO + WVO
NES = WMW + WMW
MSY = RAF + RAF
ZEG = HED + HED
DLU = VSH + VSH
QNG = GTW + GTW
NOB = PS + PS
PZF = FZX + FZX
JDY = LWS + LWS
IVG = IBD + IBD
OTO = FJS + FJS
XPQ = UMD + UMD
SLQ = PDQ + PDQ
CRN = BZC + BZC
LMZ = QXC + QXC
MGQ = XNG + XNG
DW = XGN + XGN
EWV = RC + RC
KLK = ATY + ATY
NDW = JSW + JSW
LPK = PIL + PIL
ZYD = SQP + SQP
UMO = YRY + YRY
SRO = AUP + AUP
LKX = OUP + OUP
USL = ZMT + ZMT
JQF = SVN + SVN
UCW = XRR + XRR
KLE = PIA + PIA
CBA = ZU + ZU
EIA = UBK + UBK
ZEQ = QFK + QFK
HSP = GBW + GBW
XFX = APC + APC
PNI = VQV + VQV
NAF = OJU + OJU
EJ = BQM + BQM
EUX = EEH + EEH
UNF = LUX + LUX
NUS = RVN + RVN
VNP = GOB + GOB
Z = RGK + RGK
ETZ = OVW + OVW
QXG = YOS + YOS
LVS = NAY + NAY
WFR = ZAR + ZAR
D = JOP + JOP
RWA = YJC + YJC
PCN = YDO + YDO
PPO = HWT + HWT
DWM = EAA + EAA
SJS = LHI + LHI
SFZ = OS + OS
ACN = ARW + ARW
QU = TMN + TMN
AZY = GI + GI
LO = PNL + PNL
EKL = YOS + YOS
TJW = KG + KG
CCY = PFN + PFN
QSG = FYP + FYP
QUR = PEH + PEH
YZX = NSY + NSY
QXS = PPS + PPS
JGP = EZE + EZE
WGX = SFZ + SFZ
KIM = RJR + RJR
LTK = OAL + OAL
CR = FNC + FNC
UMH = VKJ + VKJ
VGQ = UES + UES
OIR = CLI + CLI
RPI = VFL + VFL
VBA = XYS + XYS
OXG = NRL + NRL
XU = GKP + GKP
DSO = CGL + CGL
MXI = BQM + BQM
HKZ = OOX + OOX
PJX = MON + MON
VAE = AT + AT
PG = TXX + TXX
JU = AI + AI
WOX = YPK + YPK
RJL = VF + VF
LVA = OXD + OXD
GZS = YLN + YLN
ID = CEX + CEX
JSZ = RUZ + RUZ
NYS = QPT + QPT
UKI = BLN + BLN
GHV = DWR + DWR
